XXXXXXXXXXXXXXXXXXXXXXXXXXXXXXXXXXXXXXX
X    X                        X       X
X    XXXXXXX  XX  XXXXXXXX    X   X   X
X          X  XX  X           X   X   X
X   XXXXX  X  XX  X      XXXXXX   X    
X   X   X         X               X   X
X   X   X   XXXXXXX   XXX   XXXXXXXXXXX
X       XXXXX           X              
X   XXXXX   XXXXXXXXX   XXXXXXX   XXXXX
X           X           X             X
X   XXXXX   X   XXX     XXXXX     XXXXX
X       X   X   X       X   X     X   X
X       X       X   XXXXX   X          
X   XXXXXXXXX   X       X   XXXXXXX   X
X           X   X                     X
XXXXXXXXXXXXXXXXXXXXXXXXXXXXXXXXXXXXXXX
