XXXXXXXXXXXXXXXXXXXXXXXXXXXXXXXXXXXXXXX
X     X       X     X         X     X X
X XXXXX XXXXX X XXX X X XXXXX X X X X X
X       X     X   X X X X     X X X   X
XXXXX X X XXXXXXXXX XXXXX XXXXXXX XXXXX
X   X X X   X       X     X       X   X
X X X XXX XXX XXXXX X XXX XXXXXXX XXX X
X X X     X     X   X   X X     X     X
X X XXXXX X XXX XXX XXX X X XXX XXXXX X
X X     X X X X   X     X   X X X     X
X XXXXX X X X XXXXX XXXXX XXX X XXXXXXX
X     X X X       X     X     X       X
X XXX XXX XXX   X X XXX XXXXX X XXXXX X
X   X     X     X X X   X     X X   X X
XX      XXX X X X   X X  XX           X
XXXXXXXXXXXXXXXXXXXXXXXXXXXXXXXXXXXXXXX



